//MAP CONVERTED BY dmm2tgm.py THIS HEADER COMMENT PREVENTS RECONVERSION, DO NOT REMOVE
"a" = (
/turf/open/floor/wood/large,
/area/shuttle/arrival)
"b" = (
/obj/structure/table,
/obj/effect/spawner/random/food_or_drink/island_booze{
	pixel_x = 7;
	pixel_y = 7
	},
/obj/effect/spawner/random/food_or_drink/island_booze{
	pixel_y = 2;
	pixel_x = -6
	},
/obj/effect/spawner/random/clothing/island_time{
	pixel_y = 3
	},
/turf/open/floor/iron/terracotta/small,
/area/shuttle/arrival)
"c" = (
/obj/structure/window/reinforced/spawner/directional/east,
/obj/structure/table,
/obj/effect/spawner/random/food_or_drink/island_booze{
	pixel_x = 2;
	pixel_y = 5
	},
/obj/item/book/granter/magazine/biodome{
	pixel_x = -7
	},
/obj/docking_port/mobile/arrivals,
/turf/open/floor/glass/reinforced,
/area/shuttle/arrival)
"e" = (
/obj/structure/window/reinforced/spawner/directional/west,
/obj/machinery/power/shuttle_engine/heater{
	dir = 4
	},
/turf/open/floor/plating/airless,
/area/shuttle/arrival)
"f" = (
/obj/structure/table,
/obj/effect/spawner/random/food_or_drink/island_booze,
/obj/effect/spawner/random/food_or_drink/island_booze{
	pixel_x = 6;
	pixel_y = 4
	},
/obj/effect/spawner/random/clothing/island_time{
	pixel_x = -6;
	pixel_y = 7
	},
/turf/open/floor/iron/terracotta/small,
/area/shuttle/arrival)
"g" = (
/obj/effect/turf_decal/siding/wood{
	dir = 8
	},
/obj/machinery/light/directional/north{
	dir = 8
	},
/turf/open/floor/iron/terracotta/small,
/area/shuttle/arrival)
"i" = (
/obj/structure/fluff/beach_umbrella/science,
/obj/structure/window/reinforced/spawner/directional/north{
	pixel_y = 2
	},
/turf/open/floor/glass/reinforced,
/area/shuttle/arrival)
"j" = (
/obj/item/book/granter/magazine/biodome{
	pixel_y = 8;
	pixel_x = 4
	},
/turf/open/floor/iron/terracotta/small,
/area/shuttle/arrival)
"k" = (
/obj/structure/window/reinforced/spawner/directional/east,
/obj/structure/window/reinforced/spawner/directional/south{
	pixel_y = 2
	},
/obj/structure/chair/comfy/shuttle{
	dir = 4
	},
/turf/open/floor/glass/reinforced,
/area/shuttle/arrival)
"l" = (
/obj/effect/turf_decal/siding/wood{
	dir = 8
	},
/obj/machinery/light/directional/south{
	dir = 8
	},
/turf/open/floor/iron/terracotta/small,
/area/shuttle/arrival)
"m" = (
/obj/machinery/vending/vendcation,
/turf/open/floor/iron/terracotta/small,
/area/shuttle/arrival)
"o" = (
/obj/effect/turf_decal/siding/wood{
	dir = 8
	},
/obj/item/book/granter/magazine/biodome{
	pixel_x = -6
	},
/obj/effect/spawner/random/food_or_drink/island_booze{
	pixel_x = 5;
	pixel_y = 5
	},
/obj/structure/fluff/beach_umbrella,
/turf/open/floor/iron/terracotta/small,
/area/shuttle/arrival)
"p" = (
/obj/effect/turf_decal/siding/wood,
/turf/open/water/beach,
/area/shuttle/arrival)
"r" = (
/turf/open/floor/iron/terracotta/small,
/area/shuttle/arrival)
"s" = (
/obj/effect/spawner/random/clothing/island_time{
	pixel_y = -4;
	pixel_x = -3
	},
/turf/open/floor/iron/terracotta/small,
/area/shuttle/arrival)
"t" = (
/obj/structure/fluff/beach_umbrella/cap,
/turf/open/floor/iron/terracotta/small,
/area/shuttle/arrival)
"v" = (
/obj/effect/turf_decal/siding/wood{
	dir = 4
	},
/turf/open/floor/iron/terracotta/small,
/area/shuttle/arrival)
"w" = (
/obj/machinery/door/airlock/titanium{
	name = "Arrivals Shuttle Airlock"
	},
/turf/open/floor/plating,
/area/shuttle/arrival)
"x" = (
/obj/effect/turf_decal/siding/wood{
	dir = 9
	},
/turf/open/water/beach,
/area/shuttle/arrival)
"y" = (
/obj/machinery/light/directional/south,
/obj/item/radio/intercom/directional/south,
/turf/open/floor/wood/large,
/area/shuttle/arrival)
"z" = (
/obj/effect/turf_decal/siding/wood{
	dir = 4
	},
/obj/structure/closet/emcloset,
/obj/item/storage/medkit/regular,
/turf/open/floor/iron/terracotta/small,
/area/shuttle/arrival)
"A" = (
/obj/structure/chair/comfy/shuttle{
	dir = 8
	},
/turf/open/floor/wood/large,
/area/shuttle/arrival)
"B" = (
/obj/effect/spawner/random/food_or_drink/island_booze{
	pixel_x = 7
	},
/turf/open/floor/iron/terracotta/small,
/area/shuttle/arrival)
"D" = (
/obj/structure/closet/wardrobe/mixed,
/turf/open/floor/wood/large,
/area/shuttle/arrival)
"E" = (
/obj/effect/turf_decal/siding/wood{
	dir = 6
	},
/turf/open/water/beach,
/area/shuttle/arrival)
"G" = (
/obj/structure/fluff/beach_umbrella/engine,
/obj/structure/window/reinforced/spawner/directional/south{
	pixel_y = 2
	},
/turf/open/floor/glass/reinforced,
/area/shuttle/arrival)
"H" = (
/obj/structure/window/reinforced/spawner/directional/east,
/obj/structure/window/reinforced/spawner/directional/north{
	pixel_y = 2
	},
/obj/structure/chair/comfy/shuttle{
	dir = 4
	},
/turf/open/floor/glass/reinforced,
/area/shuttle/arrival)
"I" = (
/obj/effect/turf_decal/siding/wood{
	dir = 10
	},
/turf/open/water/beach,
/area/shuttle/arrival)
"K" = (
/obj/effect/turf_decal/siding/wood{
	dir = 8
	},
/turf/open/floor/iron/terracotta/small,
/area/shuttle/arrival)
"M" = (
/obj/effect/turf_decal/siding/wood,
/obj/item/toy/beach_ball,
/turf/open/water/beach,
/area/shuttle/arrival)
"O" = (
/obj/machinery/power/shuttle_engine/propulsion{
	dir = 4
	},
/turf/open/floor/plating/airless,
/area/shuttle/arrival)
"P" = (
/turf/closed/wall/mineral/titanium,
/area/shuttle/arrival)
"Q" = (
/obj/effect/turf_decal/siding/wood{
	dir = 5
	},
/turf/open/water/beach,
/area/shuttle/arrival)
"S" = (
/obj/effect/spawner/structure/window/reinforced/shuttle,
/turf/open/floor/plating,
/area/shuttle/arrival)
"T" = (
/obj/machinery/light/directional/north,
/obj/machinery/requests_console/directional/north{
	department = "Arrival shuttle"
	},
/turf/open/floor/wood/large,
/area/shuttle/arrival)
"V" = (
/obj/structure/table,
/obj/effect/spawner/random/food_or_drink/island_booze{
	pixel_y = 4
	},
/obj/effect/spawner/random/food_or_drink/island_booze{
	pixel_x = 9;
	pixel_y = 9
	},
/obj/effect/spawner/random/food_or_drink/island_booze{
	pixel_x = -4;
	pixel_y = 7
	},
/turf/open/floor/iron/terracotta/small,
/area/shuttle/arrival)
"W" = (
/obj/structure/table,
/obj/effect/spawner/random/food_or_drink/island_booze{
	pixel_x = -6;
	pixel_y = 5
	},
/obj/item/book/granter/magazine/biodome{
	pixel_x = 5
	},
/turf/open/floor/wood/large,
/area/shuttle/arrival)
"X" = (
/turf/open/floor/glass/reinforced,
/area/shuttle/arrival)
"Y" = (
/obj/effect/turf_decal/siding/wood{
	dir = 1
	},
/turf/open/water/beach,
/area/shuttle/arrival)
"Z" = (
/turf/open/space/basic,
/area/template_noop)

(1,1,1) = {"
P
P
S
S
S
P
P
"}
(2,1,1) = {"
w
g
K
o
K
l
w
"}
(3,1,1) = {"
S
m
r
x
I
B
S
"}
(4,1,1) = {"
S
b
r
Y
p
j
S
"}
(5,1,1) = {"
S
V
t
Y
M
r
S
"}
(6,1,1) = {"
S
f
r
Q
E
s
S
"}
(7,1,1) = {"
S
z
v
v
v
v
S
"}
(8,1,1) = {"
P
T
A
W
A
y
P
"}
(9,1,1) = {"
S
D
a
A
a
a
S
"}
(10,1,1) = {"
w
a
a
a
a
a
w
"}
(11,1,1) = {"
P
e
i
X
G
e
P
"}
(12,1,1) = {"
Z
O
H
c
k
O
Z
"}
