//MAP CONVERTED BY dmm2tgm.py THIS HEADER COMMENT PREVENTS RECONVERSION, DO NOT REMOVE
"a" = (
/turf/open/space/basic,
/area/space)
"p" = (
/obj/docking_port/stationary{
	dir = 8;
	dwidth = 3;
	height = 15;
	name = "arrivals";
	roundstart_template = /datum/map_template/shuttle/arrival/box;
	shuttle_id = "arrival_stationary";
	width = 7
	},
/turf/open/space/basic,
/area/space)

(1,1,1) = {"
a
a
p
a
a
"}
