//MAP CONVERTED BY dmm2tgm.py THIS HEADER COMMENT PREVENTS RECONVERSION, DO NOT REMOVE
"a" = (
/obj/docking_port/stationary{
	dir = 8;
	dwidth = 1;
	height = 13;
	name = "arrivals";
    roundstart_template = /datum/map_template/shuttle/arrival/venus_ferry;
	shuttle_id = "arrival_stationary";
	width = 5
	},
/turf/open/space/basic,
/area/space)

(1,1,1) = {"
a
"}
