//MAP CONVERTED BY dmm2tgm.py THIS HEADER COMMENT PREVENTS RECONVERSION, DO NOT REMOVE
"a" = (
/turf/open/floor/plating/airless,
/area/station/hallway/secondary/entry)
"P" = (
/obj/docking_port/stationary{
	dir = 4;
	dwidth = 3;
	height = 14;
	name = "arrivals";
	roundstart_template = /datum/map_template/shuttle/arrival/kilo;
	shuttle_id = "arrival_stationary";
	width = 7
	},
/turf/open/floor/plating/airless,
/area/station/hallway/secondary/entry)

(1,1,1) = {"
a
a
a
P
a
a
a
"}
(2,1,1) = {"
a
a
a
a
a
a
a
"}
