//MAP CONVERTED BY dmm2tgm.py THIS HEADER COMMENT PREVENTS RECONVERSION, DO NOT REMOVE
"a" = (
/obj/docking_port/stationary{
	dir = 8;
	dwidth = 3;
	height = 12;
	name = "arrivals";
	roundstart_template = /datum/map_template/shuttle/arrival/venus_biodome;
	shuttle_id = "arrival_stationary";
	width = 7
	},
/turf/open/space/openspace,
/area/space)
"N" = (
/turf/open/space/openspace,
/area/space)

(1,1,1) = {"
N
N
a
N
N
"}
